======================================================================
UNLU DUSMESI FONOTAKTIK ANALIZ RAPORU
======================================================================

Toplam isim (sozluk): 15090
Pattern (C+dar_unlu+C, 2+ hece): 5678 kelime eslesti
  - Zaten listede olan: 24 / 25
  - Listede olmayan: 5654

KURAL: Son hece CVC (C=unsuz, V=dar unlu y/i/u/u)
Bu kural cok genis - her -lyk turetmesi de eslesiyor.
Gercek unlu dusmesi sadece basit koklerde olur.

----------------------------------------------------------------------
1. ZATEN LISTEDE OLANLAR (24 kelime)
----------------------------------------------------------------------
  agyz             [+] vowel_drop
  alyn             [+] vowel_drop
  asyl             [+] exception_drop:asl
  bagyr            [+] vowel_drop
  boýun            [+] vowel_drop
  burun            [+] vowel_drop
  deňiz            [+] vowel_drop
  erin             [+] vowel_drop
  garyn            [+] vowel_drop
  gelin            [+] vowel_drop
  goýun            [+] vowel_drop
  howuz            [+] vowel_drop
  kömür            [+] vowel_drop
  köwüş            [+] vowel_drop
  mähir            [+] exception_drop:mähr
  nesil            [+] exception_drop:nesl
  ogul             [+] vowel_drop
  orun             [+] vowel_drop
  pasyl            [+] exception_drop:pasl
  sabyr            [+] vowel_drop
  sygyr            [+] vowel_drop
  tizir            [+] vowel_drop
  tomus            [+] vowel_drop
  ylym             [+] exception_drop:ylm

----------------------------------------------------------------------
2. BASIT KOKLER - LISTEDE OLMAYANLAR (1252 kelime)
   (2 hece, <=6 harf, turetme eki yok - MANUEL KONTROL GEREKLI)
----------------------------------------------------------------------
  agsyl            ->  agsl          []
  agtyk            ->  agtk          [softening]
  agyl             ->  agl           []
  agym             ->  agm           []
  agyn             ->  agn           []
  ahmyr            ->  ahmr          []
  ahun             ->  ahn           []
  ahyr             ->  ahr           []
  akgyn            ->  akgn          []
  akgyr            ->  akgr          []
  akjyk            ->  akjk          [softening]
  aktiw            ->  aktw          []
  akyl             ->  akl           []
  akym             ->  akm           []
  akyn             ->  akn           []
  algyr            ->  algr          []
  algyç            ->  algç          [softening]
  alkym            ->  alkm          []
  almyt            ->  almt          [softening]
  altyn            ->  altn          []
  alym             ->  alm           []
  alys             ->  als           []
  alşyk            ->  alşk          [softening]
  ammyr            ->  ammr          []
  andyz            ->  andz          []
  antik            ->  antk          [softening]
  anyk             ->  ank           [softening]
  argyn            ->  argn          []
  arhiw            ->  arhw          []
  armyt            ->  armt          [softening]
  arryk            ->  arrk          [softening]
  artyp            ->  artp          [softening]
  aryk             ->  ark           [softening]
  aryp             ->  arp           [softening]
  arzuw            ->  arzw          []
  asgyn            ->  asgn          []
  asgyç            ->  asgç          [softening]
  aspid            ->  aspd          []
  asyk             ->  ask           [softening]
  asyr             ->  asr           []
  atgyr            ->  atgr          []
  atuw             ->  atw           []
  atym             ->  atm           []
  atyr             ->  atr           []
  atyz             ->  atz           []
  azgyn            ->  azgn          []
  azyk             ->  azk           [softening]
  açgyr            ->  açgr          []
  aýdym            ->  aýdm          []
  aýgyr            ->  aýgr          []
  aýgyt            ->  aýgt          [softening]
  aýjyn            ->  aýjn          []
  aýryk            ->  aýrk          [softening]
  aýryt            ->  aýrt          [softening]
  aýtym            ->  aýtm          []
  aýyk             ->  aýk           [softening]
  aýyp             ->  aýp           [softening]
  aýyt             ->  aýt           [softening]
  aýyň             ->  aýň           []
  aňryk            ->  aňrk          [softening]
  aşyk             ->  aşk           [softening]
  bagjyk           ->  bagjk         [softening]
  bahyl            ->  bahl          []
  bakyr            ->  bakr          []
  baldyr           ->  baldr         []
  baldyz           ->  baldz         []
  bambuk           ->  bambk         [softening]
  bandit           ->  bandt         [softening]
  bankir           ->  bankr         []
  barin            ->  barn          []
  barit            ->  bart          [softening]
  bariý            ->  barý          []
  baryl            ->  barl          []
  baryp            ->  barp          [softening]
  barşyk           ->  barşk         [softening]
  basgyç           ->  basgç         [softening]
  basryk           ->  basrk         [softening]
  bassyr           ->  bassr         []
  basyk            ->  bask          [softening]
  batyl            ->  batl          []
  bazis            ->  bazs          []
  baýyr            ->  baýr          []
  başuç            ->  başç          [softening]
  bejit            ->  bejt          [softening]
  beliň            ->  belň          []
  benzin           ->  benzn         []
  berhiz           ->  berhz         []
  berim            ->  berm          []
  berçin           ->  berçn         []
  bidin            ->  bidn          []
  bijin            ->  bijn          []
  bilbil           ->  bilbl         []
  bilgir           ->  bilgr         []
  bilgiç           ->  bilgç         [softening]
  bilim            ->  bilm          []
  birjik           ->  birjk         [softening]
  bismil           ->  bisml         []
  bitgin           ->  bitgn         []
  bitin            ->  bitn          []
  biçim            ->  biçm          []
  biçüw            ->  biçw          []
  bişim            ->  bişm          []
  boguk            ->  bogk          [softening]
  bogul            ->  bogl          []
  bogun            ->  bogn          []
  boksit           ->  bokst         [softening]
  bokur            ->  bokr          []
  bolguç           ->  bolgç         [softening]
  bolid            ->  bold          []
  bosgun           ->  bosgn         []
  bozguç           ->  bozgç         [softening]
  bozuk            ->  bozk          [softening]
  bulgur           ->  bulgr         []
  bulut            ->  bult          [softening]
  buruk            ->  burk          [softening]
  burul            ->  burl          []
  burum            ->  burm          []
  buýnuz           ->  buýnz         []
  buýruk           ->  buýrk         [softening]
  buýuk            ->  buýk          [softening]
  buýur            ->  buýr          []
  bykyn            ->  bykn          []
  byzmyk           ->  byzmk         [softening]
  bägül            ->  bägl          []
  bähbit           ->  bähbt         [softening]
  bälçik           ->  bälçk         [softening]
  bärik            ->  bärk          [softening]
  bölüm            ->  bölm          []
  börtük           ->  börtk         [softening]
  börük            ->  börk          [softening]
  böwür            ->  böwr          []
  bükük            ->  bükk          [softening]
  bükür            ->  bükr          []
  bürgüt           ->  bürgt         [softening]
  dadym            ->  dadm          []
  dahyl            ->  dahl          []
  dakyn            ->  dakn          []
  dalçyn           ->  dalçn         []
  damdyk           ->  damdk         [softening]
  daýym            ->  daým          []
  daňyl            ->  daňl          []
  daňyn            ->  daňn          []
  daşgyn           ->  daşgn         []
  debit            ->  debt          [softening]
  degim            ->  degm          []
  degşik           ->  degşk         [softening]
  delil            ->  dell          []
  demir            ->  demr          []
  depgin           ->  depgn         []
  depim            ->  depm          []
  depin            ->  depn          []
  depiz            ->  depz          []
  derňiz           ->  derňz         []
  dessik           ->  dessk         [softening]
  dessin           ->  dessn         []
  dessur           ->  dessr         []
  deýýus           ->  deýýs         []
  deşgiç           ->  deşgç         [softening]
  deşik            ->  deşk          [softening]
  digir            ->  digr          []
  dilgir           ->  dilgr         []
  dilim            ->  dilm          []
  dogul            ->  dogl          []
  dogum            ->  dogm          []
  dogur            ->  dogr          []
  dowul            ->  dowl          []
  doýgun           ->  doýgn         []
  doýum            ->  doým          []
  doýur            ->  doýr          []
  doňuz            ->  doňz          []
  duluç            ->  dulç          [softening]
  durul            ->  durl          []
  durum            ->  durm          []
  duruz            ->  durz          []
  duzçul           ->  duzçl         []
  duýgur           ->  duýgr         []
  duýul            ->  duýl          []
  dykyz            ->  dykz          []
  dymjyk           ->  dymjk         [softening]
  dymyk            ->  dymk          [softening]
  dymşyk           ->  dymşk         [softening]
  dyrmyk           ->  dyrmk         [softening]
  dyzgyn           ->  dyzgn         []
  däliz            ->  dälz          []
  dänik            ->  dänk          [softening]
  dönük            ->  dönk          [softening]
  döwük            ->  döwk          [softening]
  döwüm            ->  döwm          []
  döwür            ->  döwr          []
  dözüm            ->  dözm          []
  dürtük           ->  dürtk         [softening]
  düwnük           ->  düwnk         [softening]
  düwün            ->  düwn          []
  düwür            ->  düwr          []
  düzgün           ->  düzgn         []
  düzzüm           ->  düzzm         []
  düzüm            ->  düzm          []
  düzüw            ->  düzw          []
  düýrüm           ->  düýrm         []
  düşgür           ->  düşgr         []
  düşgüç           ->  düşgç         [softening]
  düşnük           ->  düşnk         [softening]
  düşük            ->  düşk          [softening]
  düşüm            ->  düşm          []
  ebşit            ->  ebşt          [softening]
  efir             ->  efr           []
  egik             ->  egk           [softening]
  egin             ->  egn           []
  egrij            ->  egrj          []
  egsik            ->  egsk          [softening]
  ejik             ->  ejk           [softening]
  ejir             ->  ejr           []
  ekin             ->  ekn           []
  ekiz             ->  ekz           []
  eklin            ->  ekln          []
  elin             ->  eln           []
  elip             ->  elp           [softening]
  eljuk            ->  eljk          [softening]
  emir             ->  emr           []
  emzik            ->  emzk          [softening]
  endik            ->  endk          [softening]
  epin             ->  epn           []
  ergin            ->  ergn          []
  erik             ->  erk           [softening]
  erkin            ->  erkn          []
  ertir            ->  ertr          []
  eskiz            ->  eskz          []
  eziz             ->  ezz           []
  eňňit            ->  eňňt          [softening]
  eşik             ->  eşk           [softening]
  fabrik           ->  fabrk         [softening]
  fartuk           ->  fartk         [softening]
  forum            ->  form          []
  gabyk            ->  gabk          [softening]
  gabyr            ->  gabr          []
  gadym            ->  gadm          []
  gadyr            ->  gadr          []
  galbir           ->  galbr         []
  galif            ->  galf          []
  galyp            ->  galp          [softening]
  gamgyl           ->  gamgl         []
  gandym           ->  gandm         []
  gandyz           ->  gandz         []
  ganjyk           ->  ganjk         [softening]
  ganym            ->  ganm          []
  gapjyk           ->  gapjk         [softening]
  gapyk            ->  gapk          [softening]
  garnir           ->  garnr         []
  garnuw           ->  garnw         []
  garpyz           ->  garpz         []
  garym            ->  garm          []
  garyp            ->  garp          [softening]
  garçyn           ->  garçn         []
  gasyk            ->  gask          [softening]
  gatyk            ->  gatk          [softening]
  gatyl            ->  gatl          []
  gatyr            ->  gatr          []
  gawun            ->  gawn          []
  gazgyç           ->  gazgç         [softening]
  gazuw            ->  gazw          []
  gazyk            ->  gazk          [softening]
  gaçgyn           ->  gaçgn         []
  gaýdym           ->  gaýdm         []
  gaýtyp           ->  gaýtp         [softening]
  gaýyk            ->  gaýk          [softening]
  gaýym            ->  gaým          []
  gaýyn            ->  gaýn          []
  gaýyň            ->  gaýň          []
  gaňyr            ->  gaňr          []
  gelşik           ->  gelşk         [softening]
  gemmik           ->  gemmk         [softening]
  gemrik           ->  gemrk         [softening]
  geniý            ->  gený          []
  gerim            ->  germ          []
  gerýit           ->  gerýt         [softening]
  gezim            ->  gezm          []
  geçgin           ->  geçgn         []
  geçit            ->  geçt          [softening]
  geýim            ->  geým          []
  girrik           ->  girrk         [softening]
  gitgir           ->  gitgr         []
  gizlin           ->  gizln         []
  goduk            ->  godk          [softening]
  goltuk           ->  goltk         [softening]
  goltum           ->  goltm         []
  golçur           ->  golçr         []
  gopgun           ->  gopgn         []
  gopuk            ->  gopk          [softening]
  gopuz            ->  gopz          []
  gorul            ->  gorl          []
  gorum            ->  gorm          []
  gotur            ->  gotr          []
  gowur            ->  gowr          []
  gowuz            ->  gowz          []
  gowşut           ->  gowşt         [softening]
  goýtuk           ->  goýtk         [softening]
  goýul            ->  goýl          []
  goýum            ->  goým          []
  gradus           ->  grads         []
  grafik           ->  grafk         [softening]
  grafit           ->  graft         [softening]
  granit           ->  grant         [softening]
  gubur            ->  gubr          []
  guduk            ->  gudk          [softening]
  guduz            ->  gudz          []
  gujur            ->  gujr          []
  gultum           ->  gultm         []
  gulun            ->  guln          []
  gunduz           ->  gundz         []
  gurgun           ->  gurgn         []
  gurruk           ->  gurrk         [softening]
  gurul            ->  gurl          []
  gurum            ->  gurm          []
  gurun            ->  gurn          []
  gurçuk           ->  gurçk         [softening]
  gurşuk           ->  gurşk         [softening]
  gurşun           ->  gurşn         []
  gusuk            ->  gusk          [softening]
  guýguç           ->  guýgç         [softening]
  guýruk           ->  guýrk         [softening]
  guýul            ->  guýl          []
  guýum            ->  guým          []
  guýun            ->  guýn          []
  guşgun           ->  guşgn         []
  gyjyk            ->  gyjk          [softening]
  gyjyt            ->  gyjt          [softening]
  gykuw            ->  gykw          []
  gyltym           ->  gyltm         []
  gylym            ->  gylm          []
  gylyç            ->  gylç          [softening]
  gylçyk           ->  gylçk         [softening]
  gymyz            ->  gymz          []
  gypjyk           ->  gypjk         [softening]
  gypyk            ->  gypk          [softening]
  gyrgyn           ->  gyrgn         []
  gyrgyç           ->  gyrgç         [softening]
  gyrkuw           ->  gyrkw         []
  gyrkym           ->  gyrkm         []
  gyrlym           ->  gyrlm         []
  gyrpyk           ->  gyrpk         [softening]
  gyrtyç           ->  gyrtç         [softening]
  gyryk            ->  gyrk          [softening]
  gyryl            ->  gyrl          []
  gyrym            ->  gyrm          []
  gyryn            ->  gyrn          []
  gysgyç           ->  gysgç         [softening]
  gysyk            ->  gysk          [softening]
  gysym            ->  gysm          []
  gysyr            ->  gysr          []
  gytyk            ->  gytk          [softening]
  gyzbut           ->  gyzbt         [softening]
  gyzyk            ->  gyzk          [softening]
  gyçyn            ->  gyçn          []
  gyýkym           ->  gyýkm         []
  gyýyk            ->  gyýk          [softening]
  gyýyl            ->  gyýl          []
  gyýyn            ->  gyýn          []
  gyňyr            ->  gyňr          []
  gädik            ->  gädk          [softening]
  gämik            ->  gämk          [softening]
  gäwür            ->  gäwr          []
  gömük            ->  gömk          [softening]
  gönjük           ->  gönjk         [softening]
  görgür           ->  görgr         []
  görip            ->  görp          [softening]
  görnük           ->  görnk         [softening]
  görüm            ->  görm          []
  götin            ->  götn          []
  göwrüm           ->  göwrm         []
  göwün            ->  göwn          []
  göwüs            ->  göws          []
  göçgün           ->  göçgn         []
  göçüm            ->  göçm          []
  göýdük           ->  göýdk         [softening]
  göýül            ->  göýl          []
  göňül            ->  göňl          []
  güjük            ->  güjk          [softening]
  güjüm            ->  güjm          []
  gülmyh           ->  gülmh         []
  gümrük           ->  gümrk         [softening]
  günin            ->  günn          []
  gürrüň           ->  gürrň         []
  habyp            ->  habp          [softening]
  hakyk            ->  hakk          [softening]
  hakyt            ->  hakt          [softening]
  halif            ->  half          []
  halpyk           ->  halpk         [softening]
  halys            ->  hals          []
  hamyr            ->  hamr          []
  hamyt            ->  hamt          [softening]
  hanym            ->  hanm          []
  harpyk           ->  harpk         [softening]
  haryt            ->  hart          [softening]
  hasyl            ->  hasl          []
  hatyn            ->  hatn          []
  hazzyk           ->  hazzk         [softening]
  haýuw            ->  haýw          []
  haýyn            ->  haýn          []
  haýyr            ->  haýr          []
  haýyt            ->  haýt          [softening]
  haşdyň           ->  haşdň         []
  hažžyk           ->  hažžk         [softening]
  hekik            ->  hekk          [softening]
  hekim            ->  hekm          []
  hepbik           ->  hepbk         [softening]
  hergiz           ->  hergz         []
  hesip            ->  hesp          [softening]
  hezil            ->  hezl          []
  himik            ->  himk          [softening]
  holtum           ->  holtm         []
  horjun           ->  horjn         []
  horruk           ->  horrk         [softening]
  hortum           ->  hortm         []
  howur            ->  howr          []
  howut            ->  howt          [softening]
  hoşnut           ->  hoşnt         [softening]
  hukuk            ->  hukk          [softening]
  huruç            ->  hurç          [softening]
  hurşyt           ->  hurşt         [softening]
  husyt            ->  hust          [softening]
  huzur            ->  huzr          []
  hyjuw            ->  hyjw          []
  hymmyl           ->  hymml         []
  hyruç            ->  hyrç          [softening]
  hädis            ->  häds          []
  häkim            ->  häkm          []
  hödür            ->  hödr          []
  höküm            ->  hökm          []
  hökür            ->  hökr          []
  höwür            ->  höwr          []
  hözir            ->  hözr          []
  hüjüm            ->  hüjm          []
  hüpük            ->  hüpk          [softening]
  hütdük           ->  hütdk         [softening]
  hüwjük           ->  hüwjk         [softening]
  hüşür            ->  hüşr          []
  hüžžük           ->  hüžžk         [softening]
  iblis            ->  ibls          []
  idin             ->  idn           []
  il-gün           ->  il-gn         []
  injik            ->  injk          [softening]
  injil            ->  injl          []
  injir            ->  injr          []
  iprit            ->  iprt          [softening]
  ir-giç           ->  ir-gç         [softening]
  irgin            ->  irgn          []
  iriň             ->  irň           []
  irnik            ->  irnk          [softening]
  isim             ->  ism           []
  isrip            ->  isrp          [softening]
  içgin            ->  içgn          []
  içim             ->  içm           []
  iýmit            ->  iýmt          [softening]
  iýul             ->  iýl           []
  iýun             ->  iýn           []
  iňkis            ->  iňks          []
  iňlis            ->  iňls          []
  iňrik            ->  iňrk          [softening]
  işbil            ->  işbl          []
  işik             ->  işk           [softening]
  jahyl            ->  jahl          []
  jansyz           ->  jansz         []
  jaýryk           ->  jaýrk         [softening]
  jaýyr            ->  jaýr          []
  jebir            ->  jebr          []
  jebis            ->  jebs          []
  jerim            ->  jerm          []
  jezir            ->  jezr          []
  jezit            ->  jezt          [softening]
  jeýhun           ->  jeýhn         []
  jigit            ->  jigt          [softening]
  jirim            ->  jirm          []
  jisim            ->  jism          []
  jojuk            ->  jojk          [softening]
  jomruk           ->  jomrk         [softening]
  jomur            ->  jomr          []
  jontuk           ->  jontk         [softening]
  jozzuk           ->  jozzk         [softening]
  joşgun           ->  joşgn         []
  jugur            ->  jugr          []
  jyglym           ->  jyglm         []
  jykjyk           ->  jykjk         [softening]
  jykyr            ->  jykr          []
  jyrryk           ->  jyrrk         [softening]
  jyzzyk           ->  jyzzk         [softening]
  jyzzyn           ->  jyzzn         []
  jöhit            ->  jöht          [softening]
  jübüt            ->  jübt          [softening]
  jüljül           ->  jüljl         []
  jümjüm           ->  jümjm         []
  jüptün           ->  jüptn         []
  jürnük           ->  jürnk         [softening]
  kagyz            ->  kagz          []
  kakyl            ->  kakl          []
  kaliý            ->  kalý          []
  kalsiý           ->  kalsý         []
  kanun            ->  kann          []
  kapyr            ->  kapr          []
  kassir           ->  kassr         []
  kaýyl            ->  kaýl          []
  kaşyk            ->  kaşk          [softening]
  kejir            ->  kejr          []
  kekil            ->  kekl          []
  kelçik           ->  kelçk         [softening]
  kemis            ->  kems          []
  kempir           ->  kempr         []
  kemput           ->  kempt         [softening]
  kemsik           ->  kemsk         [softening]
  kemtik           ->  kemtk         [softening]
  keniz            ->  kenz          []
  kepgir           ->  kepgr         []
  kepil            ->  kepl          []
  kerim            ->  kerm          []
  kerpiç           ->  kerpç         [softening]
  kertik           ->  kertk         [softening]
  kesgin           ->  kesgn         []
  kesgir           ->  kesgr         []
  kesgit           ->  kesgt         [softening]
  kesgiç           ->  kesgç         [softening]
  kesik            ->  kesk          [softening]
  kesim            ->  kesm          []
  kesir            ->  kesr          []
  kesmik           ->  kesmk         [softening]
  keýgim           ->  keýgm         []
  keýik            ->  keýk          [softening]
  keýpin           ->  keýpn         []
  keýtik           ->  keýtk         [softening]
  keýşik           ->  keýşk         [softening]
  keşik            ->  keşk          [softening]
  keşim            ->  keşm          []
  kibit            ->  kibt          [softening]
  kilim            ->  kilm          []
  kilis            ->  kils          []
  kirpik           ->  kirpk         [softening]
  kitir            ->  kitr          []
  kitüw            ->  kitw          []
  kişmir           ->  kişmr         []
  kokun            ->  kokn          []
  komik            ->  komk          [softening]
  konsul           ->  konsl         []
  kontur           ->  kontr         []
  konus            ->  kons          []
  korpus           ->  korps         []
  kowul            ->  kowl          []
  kowum            ->  kowm          []
  kowçum           ->  kowçm         []
  kredit           ->  kredt         [softening]
  krizis           ->  krizs         []
  kubik            ->  kubk          [softening]
  kysym            ->  kysm          []
  käkil            ->  käkl          []
  käriz            ->  kärz          []
  kätip            ->  kätp          [softening]
  käşir            ->  käşr          []
  köjüg            ->  köjg          []
  köpük            ->  köpk          [softening]
  köpün            ->  köpn          []
  körük            ->  körk          [softening]
  kösük            ->  kösk          [softening]
  köwük            ->  köwk          [softening]
  köýük            ->  köýk          [softening]
  köňül            ->  köňl          []
  külbik           ->  külbk         [softening]
  külüň            ->  külň          []
  kümsük           ->  kümsk         [softening]
  kündük           ->  kündk         [softening]
  kürtük           ->  kürtk         [softening]
  kürüm            ->  kürm          []
  labyr            ->  labr          []
  labyz            ->  labz          []
  lagyl            ->  lagl          []
  lagym            ->  lagm          []
  latun            ->  latn          []
  latyn            ->  latn          []
  lazym            ->  lazm          []
  laçyn            ->  laçn          []
  lebiz            ->  lebz          []
  lellim           ->  lellm         []
  leýmun           ->  leýmn         []
  limit            ->  limt          [softening]
  lodyr            ->  lodr          []
  läbik            ->  läbk          [softening]
  magnit           ->  magnt         [softening]
  magtym           ->  magtm         []
  magşuk           ->  magşk         [softening]
  mahbup           ->  mahbp         [softening]
  maliý            ->  malý          []
  mantyk           ->  mantk         [softening]
  mawut            ->  mawt          [softening]
  mazlum           ->  mazlm         []
  mazmun           ->  mazmn         []
  mazut            ->  mazt          [softening]
  maýmyk           ->  maýmk         [softening]
  maýmyn           ->  maýmn         []
  maýryk           ->  maýrk         [softening]
  maýtyk           ->  maýtk         [softening]
  maýyl            ->  maýl          []
  maýyp            ->  maýp          [softening]
  maýyr            ->  maýr          []
  maňyz            ->  maňz          []
  maşyn            ->  maşn          []
  mejim            ->  mejm          []
  mejlis           ->  mejls         []
  mejnun           ->  mejnn         []
  mekir            ->  mekr          []
  melgun           ->  melgn         []
  melul            ->  mell          []
  menzil           ->  menzl         []
  metjit           ->  metjt         [softening]
  mezil            ->  mezl          []
  meýil            ->  meýl          []
  meýit            ->  meýt          [softening]
  meňiz            ->  meňz          []
  meşik            ->  meşk          [softening]
  mifik            ->  mifk          [softening]
  minus            ->  mins          []
  minut            ->  mint          [softening]
  misgin           ->  misgn         []
  mobil            ->  mobl          []
  mojuk            ->  mojk          [softening]
  monjuk           ->  monjk         [softening]
  motiw            ->  motw          []
  mowzuk           ->  mowzk         [softening]
  mukym            ->  mukm          []
  mukyt            ->  mukt          [softening]
  muskul           ->  muskl         []
  mutyg            ->  mutg          []
  mylkyk           ->  mylkk         [softening]
  myltyk           ->  myltk         [softening]
  mymyk            ->  mymk          [softening]
  myrryh           ->  myrrh         []
  myssyk           ->  myssk         [softening]
  myžžyk           ->  myžžk         [softening]
  mäjum            ->  mäjm          []
  mälim            ->  mälm          []
  möhür            ->  möhr          []
  möhüt            ->  möht          [softening]
  mömin            ->  mömn          []
  möwrit           ->  möwrt         [softening]
  möwsüm           ->  möwsm         []
  müdir            ->  müdr          []
  müflis           ->  müfls         []
  mülhit           ->  mülht         [softening]
  mürit            ->  mürt          [softening]
  mürrük           ->  mürrk         [softening]
  mürtük           ->  mürtk         [softening]
  mürşük           ->  mürşk         [softening]
  müslin           ->  müsln         []
  mütrük           ->  mütrk         [softening]
  müňkür           ->  müňkr         []
  müşdük           ->  müşdk         [softening]
  müşgil           ->  müşgl         []
  nadyl            ->  nadl          []
  nagym            ->  nagm          []
  nakyl            ->  nakl          []
  nakys            ->  naks          []
  namys            ->  nams          []
  narpyz           ->  narpz         []
  natriý           ->  natrý         []
  nazym            ->  nazm          []
  naýyp            ->  naýp          [softening]
  nebir            ->  nebr          []
  nebis            ->  nebs          []
  nebit            ->  nebt          [softening]
  nedir            ->  nedr          []
  nefrit           ->  nefrt         [softening]
  nejis            ->  nejs          []
  nepis            ->  neps          []
  nerrik           ->  nerrk         [softening]
  nesib            ->  nesb          []
  nesip            ->  nesp          [softening]
  netij            ->  netj          []
  neşir            ->  neşr          []
  niçik            ->  niçk          [softening]
  nobur            ->  nobr          []
  nogul            ->  nogl          []
  nohut            ->  noht          [softening]
  nowgül           ->  nowgl         []
  nowruz           ->  nowrz         []
  nutuk            ->  nutk          [softening]
  nägil            ->  nägl          []
  näzik            ->  näzk          [softening]
  odun             ->  odn           []
  oguz             ->  ogz           []
  ogşuk            ->  ogşk          [softening]
  okgun            ->  okgn          []
  okis             ->  oks           []
  okrug            ->  okrg          []
  okuw             ->  okw           []
  olum             ->  olm           []
  ommuk            ->  ommk          [softening]
  omruk            ->  omrk          [softening]
  omul             ->  oml           []
  omur             ->  omr           []
  omuz             ->  omz           []
  orul             ->  orl           []
  orum             ->  orm           []
  owjun            ->  owjn          []
  ownuk            ->  ownk          [softening]
  owul             ->  owl           []
  owuz             ->  owz           []
  owuç             ->  owç           [softening]
  oýtum            ->  oýtm          []
  oýuk             ->  oýk           [softening]
  oýun             ->  oýn           []
  oňur             ->  oňr           []
  oňňut            ->  oňňt          [softening]
  oňşuk            ->  oňşk          [softening]
  pahyr            ->  pahr          []
  palçyk           ->  palçk         [softening]
  pamyk            ->  pamk          [softening]
  panus            ->  pans          []
  parik            ->  park          [softening]
  parnik           ->  parnk         [softening]
  passiw           ->  passw         []
  patrul           ->  patrl         []
  pazyl            ->  pazl          []
  paýhyn           ->  paýhn         []
  paýtun           ->  paýtn         []
  paýyz            ->  paýz          []
  paşşyk           ->  paşşk         [softening]
  penjir           ->  penjr         []
  perik            ->  perk          [softening]
  pestik           ->  pestk         [softening]
  petik            ->  petk          [softening]
  petir            ->  petr          []
  pezzik           ->  pezzk         [softening]
  peýnir           ->  peýnr         []
  peýşin           ->  peýşn         []
  pikir            ->  pikr          []
  pilis            ->  pils          []
  pirim            ->  pirm          []
  pitik            ->  pitk          [softening]
  pişik            ->  pişk          [softening]
  polis            ->  pols          []
  polýus           ->  polýs         []
  poplin           ->  popln         []
  porruk           ->  porrk         [softening]
  possuk           ->  possk         [softening]
  possun           ->  possn         []
  pozguç           ->  pozgç         [softening]
  primus           ->  prims         []
  profil           ->  profl         []
  pružin           ->  pružn         []
  pygyl            ->  pygl          []
  pyntyk           ->  pyntk         [softening]
  pyrryk           ->  pyrrk         [softening]
  pyşdyl           ->  pyşdl         []
  pyşşyk           ->  pyşşk         [softening]
  pähim            ->  pähm          []
  päkiz            ->  päkz          []
  pürçük           ->  pürçk         [softening]
  radiý            ->  radý          []
  rahit            ->  raht          [softening]
  rakyp            ->  rakp          [softening]
  rebus            ->  rebs          []
  redif            ->  redf          []
  rehim            ->  rehm          []
  reksit           ->  rekst         [softening]
  repid            ->  repd          []
  resim            ->  resm          []
  rezin            ->  rezn          []
  reýis            ->  reýs          []
  režim            ->  režm          []
  ritmik           ->  ritmk         [softening]
  sabyn            ->  sabn          []
  sadyr            ->  sadr          []
  sagdyn           ->  sagdn         []
  sagyl            ->  sagl          []
  sagym            ->  sagm          []
  sagyn            ->  sagn          []
  sakgyç           ->  sakgç         [softening]
  salgym           ->  salgm         []
  salgyt           ->  salgt         [softening]
  salkym           ->  salkm         []
  saltyk           ->  saltk         [softening]
  salym            ->  salm          []
  salyn            ->  saln          []
  salýut           ->  salýt         [softening]
  sammyk           ->  sammk         [softening]
  samyr            ->  samr          []
  sandyk           ->  sandk         [softening]
  sargyt           ->  sargt         [softening]
  sarkyt           ->  sarkt         [softening]
  sarun            ->  sarn          []
  satir            ->  satr          []
  satuw            ->  satw          []
  sazmyk           ->  sazmk         [softening]
  saýgyç           ->  saýgç         [softening]
  saýym            ->  saým          []
  saýyn            ->  saýn          []
  sebit            ->  sebt          [softening]
  selin            ->  seln          []
  seljuk           ->  seljk         [softening]
  semit            ->  semt          [softening]
  sepgit           ->  sepgt         [softening]
  sergin           ->  sergn         []
  serpik           ->  serpk         [softening]
  serwis           ->  serws         []
  serwiz           ->  serwz         []
  setin            ->  setn          []
  setir            ->  setr          []
  seziý            ->  sezý          []
  seýik            ->  seýk          [softening]
  seýil            ->  seýl          []
  seýis            ->  seýs          []
  seýkin           ->  seýkn         []
  seňrik           ->  seňrk         [softening]
  sirkul           ->  sirkl         []
  sistit           ->  sistt         [softening]
  siziň            ->  sizň          []
  siýdik           ->  siýdk         [softening]
  siňir            ->  siňr          []
  siňsil           ->  siňsl         []
  siňňil           ->  siňňl         []
  siňňin           ->  siňňn         []
  sogur            ->  sogr          []
  sokur            ->  sokr          []
  solgun           ->  solgn         []
  sorguç           ->  sorgç         [softening]
  sowgut           ->  sowgt         [softening]
  sowguç           ->  sowgç         [softening]
  sowul            ->  sowl          []
  sowur            ->  sowr          []
  sowut            ->  sowt          [softening]
  soýuk            ->  soýk          [softening]
  soýul            ->  soýl          []
  soýuz            ->  soýz          []
  status           ->  stats         []
  stimul           ->  stiml         []
  sudur            ->  sudr          []
  sugun            ->  sugn          []
  surguç           ->  surgç         [softening]
  susguç           ->  susgç         [softening]
  suwjuk           ->  suwjk         [softening]
  sygym            ->  sygm          []
  sygyn            ->  sygn          []
  symrug           ->  symrg         []
  symsyk           ->  symsk         [softening]
  synyk            ->  synk          [softening]
  sypjyk           ->  sypjk         [softening]
  syrkyn           ->  syrkn         []
  syryk            ->  syrk          [softening]
  syzgyr           ->  syzgr         []
  söbük            ->  söbk          [softening]
  söltük           ->  söltk         [softening]
  sönük            ->  sönk          [softening]
  sörtük           ->  sörtk         [softening]
  söwüt            ->  söwt          [softening]
  sülgün           ->  sülgn         []
  sümmül           ->  sümml         []
  sümsük           ->  sümsk         [softening]
  sümsül           ->  sümsl         []
  sümük            ->  sümk          [softening]
  süpük            ->  süpk          [softening]
  sürgün           ->  sürgn         []
  sürgüç           ->  sürgç         [softening]
  sürüm            ->  sürm          []
  sütük            ->  sütk          [softening]
  sütün            ->  sütn          []
  süzgüç           ->  süzgç         [softening]
  süzük            ->  süzk          [softening]
  süýüm            ->  süým          []
  süýşük           ->  süýşk         [softening]
  tabyn            ->  tabn          []
  tabyt            ->  tabt          [softening]
  taglym           ->  taglm         []
  tagsyp           ->  tagsp         [softening]
  tagsyr           ->  tagsr         []
  tahyl            ->  tahl          []
  takdyr           ->  takdr         []
  takmyn           ->  takmn         []
  taktik           ->  taktk         [softening]
  takyr            ->  takr          []
  talyp            ->  talp          [softening]
  tambur           ->  tambr         []
  tamdyr           ->  tamdr         []
  tangyr           ->  tangr         []
  tankyt           ->  tankt         [softening]
  tapgyr           ->  tapgr         []
  taryh            ->  tarh          []
  taryp            ->  tarp          [softening]
  tassyk           ->  tassk         [softening]
  tasyl            ->  tasl          []
  tawus            ->  taws          []
  taýfun           ->  taýfn         []
  taýmyl           ->  taýml         []
  taňňyr           ->  taňňr         []
  tebip            ->  tebp          [softening]
  tebit            ->  tebt          [softening]
  tegmil           ->  tegml         []
  tejrib           ->  tejrb         []
  teklip           ->  teklp         [softening]
  telim            ->  telm          []
  tengin           ->  tengn         []
  tennis           ->  tenns         []
  terbiý           ->  terbý         []
  terjim           ->  terjm         []
  termik           ->  termk         [softening]
  termin           ->  termn         []
  termit           ->  termt         [softening]
  tersin           ->  tersn         []
  tertip           ->  tertp         [softening]
  teswir           ->  teswr         []
  tezis            ->  tezs          []
  tibit            ->  tibt          [softening]
  tigir            ->  tigr          []
  tikin            ->  tikn          []
  tilsim           ->  tilsm         []
  tirim            ->  tirm          []
  titir            ->  titr          []
  titul            ->  titl          []
  tohum            ->  tohm          []
  toksin           ->  toksn         []
  tommuk           ->  tommk         [softening]
  toplum           ->  toplm         []
  topuk            ->  topk          [softening]
  topur            ->  topr          []
  torsuk           ->  torsk         [softening]
  torum            ->  torm          []
  tosun            ->  tosn          []
  towuk            ->  towk          [softening]
  towus            ->  tows          []
  toýnuk           ->  toýnk         [softening]
  toýuk            ->  toýk          [softening]
  toýun            ->  toýn          []
  tropik           ->  tropk         [softening]
  tultuk           ->  tultk         [softening]
  tulum            ->  tulm          []
  tumşuk           ->  tumşk         [softening]
  turuz            ->  turz          []
  tutguç           ->  tutgç         [softening]
  tutuk            ->  tutk          [softening]
  tutul            ->  tutl          []
  tutum            ->  tutm          []
  tygşyt           ->  tygşt         [softening]
  täjir            ->  täjr          []
  tälim            ->  tälm          []
  tämiz            ->  tämz          []
  tärim            ->  tärm          []
  täsir            ->  täsr          []
  töwwir           ->  töwwr         []
  tümmül           ->  tümml         []
  tütün            ->  tütn          []
  tüýdük           ->  tüýdk         [softening]
  tüýjük           ->  tüýjk         [softening]
  tüýnük           ->  tüýnk         [softening]
  ugur             ->  ugr           []
  ujyz             ->  ujz           []
  ukyp             ->  ukp           [softening]
  ulus             ->  uls           []
  umyt             ->  umt           [softening]
  ur-tut           ->  ur-tt         [softening]
  urug             ->  urg           []
  urul             ->  url           []
  urun             ->  urn           []
  usul             ->  usl           []
  utuk             ->  utk           [softening]
  utul             ->  utl           []
  utun             ->  utn           []
  uzur             ->  uzr           []
  uçgun            ->  uçgn          []
  uçgur            ->  uçgr          []
  uçuk             ->  uçk           [softening]
  uçut             ->  uçt           [softening]
  uýgur            ->  uýgr          []
  uýul             ->  uýl           []
  uşlyp            ->  uşlp          [softening]
  wagyr            ->  wagr          []
  wagyz            ->  wagz          []
  wajyp            ->  wajp          [softening]
  warryk           ->  warrk         [softening]
  wehim            ->  wehm          []
  wekil            ->  wekl          []
  wezip            ->  wezp          [softening]
  wezir            ->  wezr          []
  wirus            ->  wirs          []
  ykgyn            ->  ykgn          []
  yklym            ->  yklm          []
  ykryk            ->  ykrk          [softening]
  ymgyr            ->  ymgr          []
  ynjyk            ->  ynjk          [softening]
  yryl             ->  yrl           []
  yrym             ->  yrm           []
  ysgyn            ->  ysgn          []
  yzgyt            ->  yzgt          [softening]
  yşgyn            ->  yşgn          []
  yşyk             ->  yşk           [softening]
  zabun            ->  zabn          []
  zahyr            ->  zahr          []
  zakgun           ->  zakgn         []
  zalym            ->  zalm          []
  zamun            ->  zamn          []
  zaryn            ->  zarn          []
  zefir            ->  zefr          []
  zehin            ->  zehn          []
  zelil            ->  zell          []
  zemin            ->  zemn          []
  zenit            ->  zent          [softening]
  zerur            ->  zerr          []
  zeýkir           ->  zeýkr         []
  zeýtun           ->  zeýtn         []
  zibil            ->  zibl          []
  zikir            ->  zikr          []
  zontik           ->  zontk         [softening]
  zorruk           ->  zorrk         [softening]
  zulum            ->  zulm          []
  zybrym           ->  zybrm         []
  zygyr            ->  zygr          []
  zynjyr           ->  zynjr         []
  zyňyl            ->  zyňl          []
  zöwük            ->  zöwk          [softening]
  zürrük           ->  zürrk         [softening]
  ädik             ->  ädk           [softening]
  ädim             ->  ädm           []
  çabyt            ->  çabt          [softening]
  çadyr            ->  çadr          []
  çagyl            ->  çagl          []
  çagşyk           ->  çagşk         [softening]
  çagşyl           ->  çagşl         []
  çakryk           ->  çakrk         [softening]
  çakrym           ->  çakrm         []
  çakyr            ->  çakr          []
  çalgyr           ->  çalgr         []
  çalyn            ->  çaln          []
  çalşyk           ->  çalşk         [softening]
  çapgyn           ->  çapgn         []
  çapgyr           ->  çapgr         []
  çapgyç           ->  çapgç         [softening]
  çapuw            ->  çapw          []
  çapyk            ->  çapk          [softening]
  çaryk            ->  çark          [softening]
  çatryk           ->  çatrk         [softening]
  çatyk            ->  çatk          [softening]
  çaýyr            ->  çaýr          []
  çaşgyn           ->  çaşgn         []
  çaşyk            ->  çaşk          [softening]
  çekim            ->  çekm          []
  çekiz            ->  çekz          []
  çekiç            ->  çekç          [softening]
  çeltik           ->  çeltk         [softening]
  çerim            ->  çerm          []
  çerrik           ->  çerrk         [softening]
  çetik            ->  çetk          [softening]
  çetin            ->  çetn          []
  çigin            ->  çign          []
  çigit            ->  çigt          [softening]
  çilim            ->  çilm          []
  çirkin           ->  çirkn         []
  çitik            ->  çitk          [softening]
  çitim            ->  çitm          []
  çitnik           ->  çitnk         [softening]
  çiňrik           ->  çiňrk         [softening]
  çokul            ->  çokl          []
  çomur            ->  çomr          []
  çomuç            ->  çomç          [softening]
  çopur            ->  çopr          []
  çozgun           ->  çozgn         []
  çoýun            ->  çoýn          []
  çugdum           ->  çugdm         []
  çukur            ->  çukr          []
  çulum            ->  çulm          []
  çuňňur           ->  çuňňr         []
  çybyk            ->  çybk          [softening]
  çybyn            ->  çybn          []
  çygyl            ->  çygl          []
  çygyr            ->  çygr          []
  çykgyt           ->  çykgt         [softening]
  çykuw            ->  çykw          []
  çylgym           ->  çylgm         []
  çylpyk           ->  çylpk         [softening]
  çymçyk           ->  çymçk         [softening]
  çyrpym           ->  çyrpm         []
  çyrçyk           ->  çyrçk         [softening]
  çytyk            ->  çytk          [softening]
  çyzgyç           ->  çyzgç         [softening]
  çyzmyk           ->  çyzmk         [softening]
  çyzuw            ->  çyzw          []
  çyzyk            ->  çyzk          [softening]
  çökgün           ->  çökgn         []
  çökgüt           ->  çökgt         [softening]
  çöküt            ->  çökt          [softening]
  çöpür            ->  çöpr          []
  çöwrük           ->  çöwrk         [softening]
  çözgüt           ->  çözgt         [softening]
  çümmük           ->  çümmk         [softening]
  çürrük           ->  çürrk         [softening]
  çürtüm           ->  çürtm         []
  çürşük           ->  çürşk         [softening]
  çüýjük           ->  çüýjk         [softening]
  öküz             ->  ökz           []
  öl-suw           ->  öl-sw         []
  ölüm             ->  ölm           []
  ölşük            ->  ölşk          [softening]
  ömür             ->  ömr           []
  öndüm            ->  öndm          []
  önüm             ->  önm           []
  örgün            ->  örgn          []
  örküç            ->  örkç          [softening]
  örtük            ->  örtk          [softening]
  örüm             ->  örm           []
  ötgün            ->  ötgn          []
  ötgür            ->  ötgr          []
  ötük             ->  ötk           [softening]
  öwrüm            ->  öwrm          []
  öwüt             ->  öwt           [softening]
  öwüç             ->  öwç           [softening]
  öwşün            ->  öwşn          []
  öçgün            ->  öçgn          []
  öçük             ->  öçk           [softening]
  öýdüm            ->  öýdm          []
  öýjük            ->  öýjk          [softening]
  öňňil            ->  öňňl          []
  öňňin            ->  öňňn          []
  übtük            ->  übtk          [softening]
  ümsüm            ->  ümsm          []
  ümzük            ->  ümzk          [softening]
  ümür             ->  ümr           []
  üpjün            ->  üpjn          []
  ürgün            ->  ürgn          []
  ürpük            ->  ürpk          [softening]
  üstün            ->  üstn          []
  ütük             ->  ütk           [softening]
  üzük             ->  üzk           [softening]
  üzüm             ->  üzm           []
  üçbir            ->  üçbr          []
  üňüz             ->  üňz           []
  üşük             ->  üşk           [softening]
  ýagdyn           ->  ýagdn         []
  ýagmyr           ->  ýagmr         []
  ýagyn            ->  ýagn          []
  ýagyr            ->  ýagr          []
  ýakut            ->  ýakt          [softening]
  ýakym            ->  ýakm          []
  ýaljyk           ->  ýaljk         [softening]
  ýalkym           ->  ýalkm         []
  ýalyn            ->  ýaln          []
  ýalňyz           ->  ýalňz         []
  ýamyz            ->  ýamz          []
  ýangyn           ->  ýangn         []
  ýangyt           ->  ýangt         [softening]
  ýangyç           ->  ýangç         [softening]
  ýanjyk           ->  ýanjk         [softening]
  ýantyk           ->  ýantk         [softening]
  ýanyk            ->  ýank          [softening]
  ýanyn            ->  ýann          []
  ýapgyt           ->  ýapgt         [softening]
  ýapgyç           ->  ýapgç         [softening]
  ýapryk           ->  ýaprk         [softening]
  ýapyk            ->  ýapk          [softening]
  ýaryk            ->  ýark          [softening]
  ýarym            ->  ýarm          []
  ýarçyk           ->  ýarçk         [softening]
  ýasmyk           ->  ýasmk         [softening]
  ýassyk           ->  ýassk         [softening]
  ýassyn           ->  ýassn         []
  ýatuw            ->  ýatw          []
  ýatym            ->  ýatm          []
  ýazgyn           ->  ýazgn         []
  ýazgyt           ->  ýazgt         [softening]
  ýazuw            ->  ýazw          []
  ýazyk            ->  ýazk          [softening]
  ýaýgyn           ->  ýaýgn         []
  ýaýjyk           ->  ýaýjk         [softening]
  ýaýlym           ->  ýaýlm         []
  ýaýyk            ->  ýaýk          [softening]
  ýaşyt            ->  ýaşt          [softening]
  ýaşçik           ->  ýaşçk         [softening]
  ýaşşik           ->  ýaşşk         [softening]
  ýelgin           ->  ýelgn         []
  ýelim            ->  ýelm          []
  ýelin            ->  ýeln          []
  ýeljik           ->  ýeljk         [softening]
  ýelmik           ->  ýelmk         [softening]
  ýempik           ->  ýempk         [softening]
  ýemrik           ->  ýemrk         [softening]
  ýemşik           ->  ýemşk         [softening]
  ýenjik           ->  ýenjk         [softening]
  ýepik            ->  ýepk          [softening]
  ýerin            ->  ýern          []
  ýerküm           ->  ýerkm         []
  ýesir            ->  ýesr          []
  ýetik            ->  ýetk          [softening]
  ýetim            ->  ýetm          []
  ýezit            ->  ýezt          [softening]
  ýigit            ->  ýigt          [softening]
  ýirik            ->  ýirk          [softening]
  ýitik            ->  ýitk          [softening]
  ýoksul           ->  ýoksl         []
  ýokum            ->  ýokm          []
  ýolguç           ->  ýolgç         [softening]
  ýolun            ->  ýoln          []
  ýomut            ->  ýomt          [softening]
  ýonguç           ->  ýongç         [softening]
  ýorgun           ->  ýorgn         []
  ýorgut           ->  ýorgt         [softening]
  ýoýuk            ->  ýoýk          [softening]
  ýoýul            ->  ýoýl          []
  ýugrum           ->  ýugrm         []
  ýugur            ->  ýugr          []
  ýumruk           ->  ýumrk         [softening]
  ýumuk            ->  ýumk          [softening]
  ýumul            ->  ýuml          []
  ýumur            ->  ýumr          []
  ýuwdum           ->  ýuwdm         []
  ýuwul            ->  ýuwl          []
  ýuwun            ->  ýuwn          []
  ýygryk           ->  ýygrk         [softening]
  ýygyl            ->  ýygl          []
  ýygym            ->  ýygm          []
  ýygyn            ->  ýygn          []
  ýygyr            ->  ýygr          []
  ýykyk            ->  ýykk          [softening]
  ýyldyz           ->  ýyldz         []
  ýylgyn           ->  ýylgn         []
  ýylpyr           ->  ýylpr         []
  ýylyn            ->  ýyln          []
  ýylçyr           ->  ýylçr         []
  ýympyk           ->  ýympk         [softening]
  ýyrtyk           ->  ýyrtk         [softening]
  ýörgür           ->  ýörgr         []
  ýörit            ->  ýört          [softening]
  ýüwrük           ->  ýüwrk         [softening]
  ýüzgür           ->  ýüzgr         []
  ýüzgüç           ->  ýüzgç         [softening]
  ýüzin            ->  ýüzn          []
  ýüzük            ->  ýüzk          [softening]
  şahyr            ->  şahr          []
  şaldyr           ->  şaldr         []
  şapbyk           ->  şapbk         [softening]
  şarik            ->  şark          [softening]
  şarpyk           ->  şarpk         [softening]
  şaryk            ->  şark          [softening]
  şatut            ->  şatt          [softening]
  şehit            ->  şeht          [softening]
  şekil            ->  şekl          []
  şepbik           ->  şepbk         [softening]
  şerif            ->  şerf          []
  şerim            ->  şerm          []
  şilliň           ->  şillň         []
  şindiz           ->  şindz         []
  şirin            ->  şirn          []
  şitil            ->  şitl          []
  şorsuw           ->  şorsw         []
  şowhun           ->  şowhn         []
  şugul            ->  şugl          []
  şurruk           ->  şurrk         [softening]
  şybyk            ->  şybk          [softening]
  şygyr            ->  şygr          []
  şypbyk           ->  şypbk         [softening]
  şänik            ->  şänk          [softening]
  şärik            ->  şärk          [softening]

----------------------------------------------------------------------
3. TURETILMIS KELIMELER -lyk/-lik (2688 kelime)
   (Bu kelimeler unlu dusmesine ugramaz - turetme soneki)
----------------------------------------------------------------------
  abadanlyk
  abadançylyk
  abatlyk
  abatçylyk
  abbatlyk
  abraýlylyk
  abraýsyzlyk
  abstraktlyk
  adaglylyk
  adalatlylyk
  adalatsyzlyk
  adalyk
  adamhorlyk
  adamkärlik
  adamkärçilik
  adamlyk
  adamsyzlyk
  adamsöýüjilik
  adamçylyk
  adatylyk
  adekwatlyk
  administratorlyk
  admirallyk
  adwokatlyk
  adyllyk
  adylsyzlyk
  adyrlyk
  adýutantlyk
  agalyk
  agaçlyk
  ... ve 2658 kelime daha

----------------------------------------------------------------------
4. TURETILMIS KELIMELER -ys/-is (581 kelime)
----------------------------------------------------------------------
  abadanlaşdyryş
  abatlandyryş
  abatlaýyş
  aglaýyş
  agynaýyş
  agzaýyş
  aklaýyş
  akyl-huş
  alagaýyş
  alakjaýyş
  aldaýyş
  aljyraýyş
  alkyş
  alnyş
  alyş
  alyş-çalyş
  analizleýiş
  anyklanylyş
  anyklanyş
  anyklaýyş
  arassalanyş
  arassalaýyş
  araýyş
  argyş
  artbagyş
  artyş
  aryş
  arzanladyş
  atlandyryş
  awlaýyş
  ... ve 551 kelime daha

----------------------------------------------------------------------
5. DIGER TURETILMIS/UZUN KELIMELER (1133 kelime)
----------------------------------------------------------------------
  abažur
  absolýut
  absolýutistik
  abyr-zabyr
  adajyk
  adamjyk
  adamsit
  administratiw
  adonis
  adonit
  adrenalin
  aerolit
  aforistik
  agaçjyk
  agdarylyşyk
  agglýutinatiw
  agitkollektiw
  agnostik
  agressiw
  agrobiologik
  agromaksimum
  agromelioratiw
  agrominimum
  agronomik
  agymtyl
  agynyk
  agyr-agyr
  agyzdyryk
  agyzma-agyz
  agyzzyryk
  ... ve 1103 kelime daha

----------------------------------------------------------------------
6. LISTEDE OLUP PATTERN ESLESMEYENLER
----------------------------------------------------------------------
  gobek           (hece:2, son-2:'e', son:'k')

======================================================================
SONUC
Kural tabanli yaklasim 5654 false-positive uretir.
Manuel kontrol gereken basit kokler: 1252 kelime.
Mevcut liste tabanli yaklasim dogru strateji.
